馁	nwu
睁	vgo
臊	sco
珣	xyw
嫂	scn
猸	mwq
袂	mwp
眉	mwv
血	xtp
踅	xtz
泶	xtx
莓	mwc
寐	mwb
削	xtd
穴	xtb
煤	mwh
搔	scf
烷	wjh
淳	iyd
挽	wjf
丸	wjg
顽	wje
膂	lvo
万	wja
珑	lsw
诏	vcy
畹	wjt
碗	wju
枋	fhm
肪	fho
妨	fhn
翟	zdy
房	fhh
钫	fhj
甾	zdv
鲂	fha
芳	fhc
栽	zdm
瘟	wfb
访	fhy
哉	zdk
坊	fht
舫	fhv
纺	fhs
韫	wfa
祛	qup
呐	nek
喾	kux
矻	kuu
堀	kut
绔	kus
哭	kuq
裤	kup
诎	quy
枯	kum
雯	wfy
讷	ney
刳	kud
苦	kuc
窟	kub
啄	vok
商	uhl
咣	glk
桄	glm
竦	ssl
胱	glo
伞	sjr
醇	iyy
缎	drs
短	dru
簖	drv
煅	drh
逛	glz
锻	drj
端	drl
犷	glq
诱	yzy
劬	qug
卓	voa
凋	dnd
掉	dnf
鲷	dna
儡	lwr
缧	lws
羸	lww
貂	dnv
嫘	lwn
雕	dnp
檑	lwm
蕾	lwc
耒	lwa
擂	lwf
勒	lwg
炖	dyh
鬣	lpa
尖	jmx
聍	nke
拧	nkf
裥	jmp
柠	nkm
坚	jmt
吭	kgk
饵	eru
条	tnw
珥	erw
儿	erp
贰	erq
佴	err
佻	tnr
噱	xtk
迩	erz
弍	ere
挑	tnf
苕	tnc
窕	tnb
鸸	ern
吅	ssk
铒	erj
铫	tnj
搣	mpf
砟	vau
乜	mpg
歃	uap
纱	uas
帱	czj
煞	uah
辏	czi
杉	uam
腠	czo
鲨	uaa
莎	uac
痧	uab
攉	hof
奀	ena
蒽	enc
摁	enf
夥	hoa
耠	hol
蜿	wji
㸌	hoh
蠖	hoi
钰	yuj
祸	hop
瞻	vjo
惑	hox
霍	hoy
辣	lal
蜡	lai
剌	lad
泽	zed
站	vjl
瘌	lab
邋	laz
垃	lat
砬	lau
搐	iuf
鸩	vfn
轸	vfi
稹	vfh
阵	vfe
蓁	vfc
臻	vfa
䟴	vfz
珍	vfw
箴	vfv
砧	vfu
缜	vfs
侦	vfr
斟	vfq
祯	vfp
责	zeb
帻	zej
迕	wuz
澎	pgd
韶	ucl
蜈	wui
焐	wuh
晤	wuo
腔	qlo
朔	uoq
硕	uou
蒴	uoc
搠	uof
铄	uoj
烁	uoh
妁	uon
槊	uom
棚	pgm
蟠	pji
拌	pjf
爿	pja
嘭	pgk
荤	hyc
烹	pgh
蹒	pjz
磐	pju
畔	pjt
蟛	pgi
旒	lqf
崽	zdx
仄	zei
篷	pgv
勋	xyk
菘	ssc
颥	ruy
唛	mdk
绚	xrs
脉	mdo
荬	mdc
劢	mda
麦	mdf
迈	mdz
霾	mdy
昃	zeo
埋	mdt
卖	mdu
椁	gom
聘	pbe
幢	vlj
冬	dsw
垌	dst
掴	gof
果	goa
嗡	wgk
氡	dsq
鸫	dsn
栋	dsm
咚	dsk
埚	got
裹	gow
虢	gov
东	dsa
鲵	nia
贫	pbb
隹	vvr
迮	zez
蜣	qli
溺	nid
疟	ntb
逆	niz
翀	isy
须	xup
蚤	zcy
重	isp
充	isw
艟	isv
铳	isj
砉	xuf
种	ish
茺	isc
宠	isb
虫	isa
盱	xuo
舂	isf
崇	ise
㳘	isd
圊	qkk
珢	kfw
垦	kft
攮	nhf
晴	qko
裉	kfp
靖	qkl
苘	qkc
曩	nho
恳	kfx
清	qkd
情	qkx
綮	qks
倾	qkr
卿	qkp
勍	qkw
啃	kfk
龈	kfi
猊	niq
扱	xif
佗	tor
乇	top
坨	tot
砣	tou
铊	toj
细	xis
鸵	ton
坭	nit
蹊	xiz
尼	niu
庹	tog
沱	tod
陀	toe
滚	gyd
鲧	gya
驵	zhm
棍	gym
辊	gyi
衮	gyw
磙	gyu
绲	gys
孅	qmi
袍	pcp
耨	nzl
磷	lbu
霖	lby
懔	lbx
蔺	lbc
赁	lbb
廪	lbg
拎	lbf
辚	lbi
筛	udv
啉	lbk
麟	lbl
珈	jxw
笳	jxv
袈	jxy
恝	jxx
整	vga
症	vgb
蒸	vgc
浃	jxd
蛱	jxi
稼	jxh
㗎	jxk
缥	pns
胛	jxo
嫁	jxn
涯	yad
戎	rsg
鳘	mba
逡	qyz
裙	qyp
麇	qyl
囷	qyk
饨	tyu
褪	typ
氽	tyr
裂	lpy
埒	lpt
掇	dof
度	dog
惰	dox
咧	lpk
馨	xbu
烈	lph
缍	dos
裰	dop
舵	dov
躲	dou
苠	mbc
莱	ldc
乒	pkp
瓶	pkq
坪	pkt
屏	pku
撞	vlf
评	pky
鲆	pka
呯	pkk
娉	pkn
枰	pkm
欢	hry
患	hrx
逭	hrz
垸	hrt
环	hrw
幻	hrv
獾	hrq
桓	hrm
㬊	hro
焕	hrh
郇	hre
擐	hrf
萑	hrc
戆	vlx
睐	ldo
坝	bat
罢	bas
八	bap
徕	ldr
跋	baz
灞	bad
岜	bae
疤	bab
耙	bal
钯	baj
蚆	bai
孥	nuz
囟	xbp
胬	nur
奴	nun
躜	zrz
努	nul
驽	num
帑	nuj
弩	nug
坶	mut
遄	irz
母	muv
牟	mus
仫	mur
氚	irq
霂	muy
船	irv
沐	mud
钏	irj
喘	irk
木	mua
椽	irm
串	ira
穿	irb
穆	muh
钼	muj
爪	vxp
信	xbr
呣	omk
床	ilg
创	ild
疮	ilb
蹉	coz
幢	ilj
鹾	coa
痤	cob
嵯	coe
剒	cod
厝	coi
唶	cok
锉	coj
嘌	pnk
怆	ilx
挂	gxf
剋	kwd
寡	gxb
栝	gxm
鸹	gxn
胍	gxo
铦	gxj
卦	gxt
蛩	qsi
诖	gxy
卅	saa
牦	mcn
髦	mcm
祫	xxp
瑕	xxw
歪	wda
旄	mcf
泖	mcd
贸	mcb
瘕	xxb
夏	xxa
罅	xxf
峡	xxe
懋	mcx
貌	mcv
耄	mct
猫	mcq
崴	wde
吻	wfk
蚊	wfi
霭	aiy
欸	ais
暧	aio
嫒	ain
锿	aij
偷	tzr
箐	qkv
透	tzz
骰	tzg
投	tzf
馓	sju
档	dhm
凼	dhk
铛	dhj
留	lqt
挡	dhf
氹	dhd
宕	dhb
绺	lqs
熘	lqh
谠	dhy
党	dhx
珰	dhw
陆	lqe
砀	dhu
瘤	lqb
裆	dhp
铌	nij
匿	nik
警	jky
迳	jkz
惴	vvx
境	jkt
兢	jku
獍	jkq
婧	jkn
锥	vvj
镜	jkj
阱	jke
弪	jkg
痉	jkb
瑭	thw
躺	thu
膛	tho
耥	thl
嘡	thk
烫	thh
唐	thg
搪	thf
靥	yei
烨	yeh
搦	nof
页	yeb
谒	yey
秀	xqh
堨	yet
夜	yew
庤	vig
蛤	hai
铪	haj
噏	hak
俵	bnr
飙	bnq
裱	bnp
彪	bnh
膘	bno
婊	bnn
吱	vik
瘭	bnb
佬	lcr
络	lcs
葜	qxc
鸷	vin
捞	lcf
碹	xru
涝	lcd
崂	lce
劳	lcc
耢	lcl
栳	lcm
唠	lck
烙	lch
堨	vdt
鳖	bpa
珺	jyw
欸	vds
瘪	bpb
髂	qxg
洽	qxd
砦	vdv
翟	vdy
婪	ljn
捃	jyf
憋	bpx
蹩	bpz
钧	jyj
蓝	ljc
焌	jyh
致	viw
玮	www
艉	wwv
糟	zcm
威	wwg
申	ufa
痿	wwb
韪	wwo
钞	icj
晁	ico
郢	yke
耖	icl
嘤	ykk
蝇	yki
朽	xqm
弨	icg
抄	icf
椰	yem
缨	yks
怊	icx
硬	yku
绰	ics
迎	ykz
巢	icv
朝	icu
宏	hsb
旺	who
烘	hsh
竑	hsl
闳	hsm
兰	ljq
姨	yin
黉	hsx
讧	hsy
写	xpb
俎	zur
祖	zup
骏	jym
卒	zuw
诅	zuy
菹	zuc
族	zuf
斓	ljw
阻	zue
镞	zuj
足	zuk
租	zuh
篮	ljv
苤	ppc
蓑	soc
旻	mbo
埙	xyt
巽	xyv
卬	ahe
泯	mbd
岷	mbe
抿	mbf
锁	soj
瞥	ppo
睃	soo
盎	ahm
鲟	xya
氕	ppq
琐	sow
旬	xyg
羧	soy
愬	sox
驯	xym
缗	mbs
腽	wao
镭	lwj
皂	zcb
蛙	wai
搲	waf
荮	vzc
佤	war
肋	lwo
宿	xqb
㧑	wwf
慷	khx
脐	qio
启	qih
颀	qij
犺	khq
伉	khr
溺	nnd
茑	nnc
甯	nkb
亢	khw
炕	khh
钪	khj
尿	nnu
歧	qiv
扛	khf
康	khg
娓	wwn
醍	tiy
杏	xkm
屉	tiu
形	xka
裼	tip
倜	tir
鹈	tin
锑	tij
提	tif
猩	xkq
鳀	tia
荑	tic
揆	kvf
魁	kvg
窥	kvb
瘿	ykb
盔	kvm
馗	kvj
蝰	kvi
篑	kvv
馈	kvu
傀	kvr
夔	kvq
狞	nkq
佞	nkr
踉	llz
谅	lly
婼	ron
俩	llr
亮	llw
墚	llt
辆	lli
莨	llc
偌	ror
魉	llg
靓	llf
箬	rov
巛	vev
铿	kgj
瞧	qno
遮	vez
谪	vey
婷	tkn
浙	ved
痾	veb
蔗	vec
鹧	ven
晢	veo
柘	vem
锗	vej
滦	lrd
恂	xyx
卵	lrp
笤	tnv
傩	nor
祧	tnp
帝	dil
睇	dio
镝	dij
邸	die
弟	dib
罟	gus
估	gur
尐	dix
敌	diw
狄	diq
缔	dis
燊	ufh
篇	pmv
蜃	ufi
谝	pmy
蹁	pmz
狰	vgq
胼	pmo
粜	tne
缵	zrs
诹	zzy
筐	klv
攥	zrf
馊	szu
谰	ljy
眺	tno
慎	ufx
砵	boi
鹁	bon
帛	bob
熟	uzh
杀	uax
甚	ufq
艏	uzv
收	uzw
手	uzp
绶	uzs
乳	ruv
橼	yrm
痈	ysb
痾	oob
汭	rvd
盛	ugm
厦	uai
宴	yjb
霜	uly
礤	cau
殷	yjp
铩	uaj
孀	uln
蔷	qlc
恹	yjx
种	vsh
延	yjz
馐	xqu
媾	gzn
锟	kyj
钩	gzj
阃	kym
远	yrz
沟	gzd
岣	gze
购	gzb
醌	kyy
悃	kyx
遘	gzz
诟	gzy
垢	gzt
彀	gzu
佝	gzr
缑	gzs
狗	gzq
籀	vzv
胯	kxo
绷	bgs
堋	bgt
廒	aog
拗	aof
澳	aod
码	mau
翱	aob
马	mav
媪	aon
骜	aom
鏖	aol
嗷	aok
鏊	aoj
螯	aoi
熬	aoh
坳	aot
傲	aor
獒	aoq
捆	kyf
遨	aoz
懊	aox
松	ssm
戆	ghx
跨	kxz
港	ghd
岗	ghe
肛	gho
钢	ghj
冈	ghk
拢	lsf
泷	lsd
钝	dyj
獯	xyq
胧	lso
咙	lsk
笼	lsv
沌	dyd
勐	mgz
揼	dyf
氮	djq
丹	djp
儋	djr
诞	djy
惮	djx
麂	jil
石	dja
萏	djc
弹	djg
糯	nom
娜	non
锘	noj
喏	nok
块	kkt
筷	kkv
狯	kkq
昙	tjo
侩	kkr
袒	tjp
脍	kko
懦	nox
诺	noy
哙	kkk
郐	kke
㧟	kkf
蒉	kkc
响	xlk
香	xlh
降	xle
啭	vrk
缩	sos
索	sou
饷	xlu
缃	xls
像	xlr
邱	qqe
貉	hcv
壕	hct
皓	hcb
郝	hce
镐	hcj
蚝	hci
耗	hcl
搡	shf
练	lms
炼	lmh
蠊	lmi
鲢	lma
帘	lmb
联	lme
廉	lmg
邅	vjz
谵	vjy
酸	sry
绽	vjs
颤	vjw
域	yut
展	vju
咹	vjk
巯	qqv
鸣	mkn
蘸	vjc
战	vja
崭	vje
洼	wad
拶	zaf
砸	zau
乙	yig
姹	ian
夷	yia
嵖	iae
懈	xpx
蟀	uki
摔	ukf
猹	iaq
衩	iap
岵	hue
护	huf
弧	hug
斛	huj
螵	pni
笏	huv
瞟	pno
嫖	pnn
醐	huy
鞣	rzg
揉	rzf
铘	yej
偬	zsr
糅	rzm
踪	zsz
㫰	lho
柔	rzs
宗	zsb
袜	wap
蹂	rzz
岸	ane
脎	sao
案	anb
飒	sal
萨	sac
鹌	ann
黯	anh
铵	anj
俺	anr
邕	ysv
仨	sar
琨	kyw
谙	any
莼	iyc
撮	zof
座	zog
乖	gkp
祚	zop
坐	zot
左	zou
笮	zov
酢	zoy
拐	gkf
舜	uyv
甄	vfx
怩	nix
吮	uyk
瞬	uyo
霓	niy
挺	tkf
庭	tkg
汀	tkd
聤	tke
酿	nly
龠	ytr
梃	tkm
铤	tkj
烃	tkh
艇	tkv
亭	tkw
町	tkt
乌	wup
停	tkr
择	zef
廷	tkz
霆	tky
鲜	xma
现	xmw
祆	xmp
纥	ges
袼	gep
惇	dyx
舸	gev
墩	dyt
敦	dyw
盾	dyp
挎	kxf
骻	kxg
疙	geb
盹	dyo
骼	geg
搁	gef
隔	gee
㧐	ssf
鸽	gen
哿	gel
税	uvh
跷	qnz
辽	lnz
睡	uvo
獠	lnq
缭	lns
僚	lnr
瞭	lno
鹩	lnn
燎	lnh
嘹	lnk
聊	lne
潦	lnd
廖	lng
蓼	lnc
觉	jtx
悦	ytx
蹶	jtz
玥	ytw
獗	jtq
约	yts
绝	jts
倔	jtr
矍	jto
厥	jti
爝	jth
崛	jte
鳜	jta
蕨	jtc
酴	tuy
途	tuz
臧	zhg
徒	tur
堍	tut
秃	tuh
钍	tuj
吐	tuk
凸	tua
突	tub
拄	vuf
玎	dkw
町	dkt
仃	dkr
刊	kjd
崁	kje
瞩	vuo
瞰	kjo
珠	vuw
顶	dkd
耵	dke
疔	dkb
纻	vus
丁	dka
撰	vrf
颛	vre
虺	hva
珀	pow
贿	hvb
挥	hvf
迴	hvz
叵	pok
毁	hvp
徽	hvr
堕	hvt
珲	hvw
踵	vsz
咆	pck
砲	pci
硝	xnu
苄	bmc
鳊	bma
鞭	bmg
莰	kjc
匾	bmk
蝙	bmi
嬛	qsn
便	bmr
褊	bmp
邾	vue
笾	bmv
变	bmw
遍	bmz
跫	qsz
忭	bmx
辩	bmy
柚	yzm
亥	hdw
欸	eis
寺	sit
氦	hdq
姓	xkn
孩	hdz
醢	hdy
庖	pcg
骸	hdg
海	hdd
害	hdb
胲	hdo
骇	hdm
麈	vul
陲	ive
捶	ivf
邰	tde
炊	ivh
锤	ivj
缪	mqs
垂	ivp
耍	uxa
花	hxc
画	hxa
砉	hxf
哗	hxk
铧	hxj
趴	paz
翥	vut
化	hxr
猾	hxq
华	hxu
话	hxy
啪	pak
耙	pal
捺	naf
叛	pjb
蛘	yhi
跚	ujz
杨	yhm
埏	ujt
舢	ujv
艚	ccv
鞅	yhg
肏	ccr
螬	cci
蟮	uji
嘈	cck
漕	ccd
操	ccf
鳝	uja
绱	uhs
垓	gdt
改	gdw
擤	xkf
丐	gda
赅	gdb
溉	gdd
陔	gde
冢	vsb
戤	gdg
迫	poz
拿	nar
窨	xyb
衲	nap
笸	pov
醒	xky
坡	pot
谟	moy
辋	whi
拏	nau
馍	mou
墨	mot
镆	moj
模	mom
耱	mol
陌	moe
婆	pon
赶	gjz
感	gjx
酐	gjy
竿	gjv
坩	gjt
矸	gju
绀	gjs
赣	gjl
尴	gjj
咁	gjk
秆	gjh
擀	gjf
疳	gjb
忒	tvq
褪	tvp
咩	mpk
腿	tvo
蜕	tvi
推	tvf
泼	pod
怠	ddx
妫	gvn
绐	dds
胄	vza
玳	ddw
庋	gvg
郐	gve
跪	gvz
诡	gvy
棣	ddm
傀	gvr
贷	ddb
鬼	gvp
舟	vzp
瑰	gvw
圭	gvt
呔	tdk
埝	nmt
碾	nmu
乔	qnp
缲	qns
蠛	mpi
念	nmx
汰	tdd
撬	qnf
蔫	nmc
窍	qnb
粘	nmm
唸	nmk
黏	nmh
豆	dza
蒜	src
蔸	dzc
斗	dzd
效	xnw
抖	dzf
蚪	dzi
肖	xnx
钭	dzj
祃	map
狻	srq
崤	xne
魈	xng
篼	dzv
蛸	xni
逗	dzz
琊	yaw
晓	xno
瓣	bjg
阪	bje
班	bjd
犬	qrd
仔	zir
昄	bjo
板	bjm
圈	qrk
酝	yyy
钣	bjj
运	yyz
斑	bjw
坂	bjt
绊	bjs
伴	bjr
筌	qrv
版	bjp
踡	qrz
熨	yyh
貉	hev
劾	hew
纥	hes
烙	loh
螺	loi
诃	hey
郃	hee
裸	lop
猡	loq
箩	lov
翮	hea
贺	heb
鹤	hen
曷	heo
龁	hei
龃	jui
犋	jun
裾	jup
苒	rjc
琚	juw
蚺	rji
燃	rjh
盅	vsm
掌	vhx
璋	vhw
獐	vhq
胀	vho
嫜	vhn
蟑	vhi
张	vhg
丈	vha
茕	qsc
趄	qpz
虱	uig
穹	qsb
锐	rvj
蚋	rvi
铈	uij
势	uil
枘	rvm
始	uin
市	uiw
琤	igw
唷	yok
邛	qse
耦	oul
逞	igz
惩	igx
澄	igd
宬	igb
銎	qsj
呈	igk
蛏	igi
怦	pgx
閪	hwm
嘿	hwk
烝	vgh
妾	qpl
窀	vyb
心	xbd
咛	nkk
销	xnj
瓮	wgb
筝	vgv
涡	god
琼	qsw
筇	qsv
骚	scm
邈	mnz
硐	dsu
侗	dsr
鳋	sca
政	vgw
瘙	scb
秒	mnh
黝	yzh
喵	mnk
杪	mnm
埽	sct
描	mnf
庙	mng
拇	muf
屯	vya
黜	iuh
蔑	mpc
伐	far
罚	fas
乏	fap
珐	faw
垡	fat
砝	fau
篾	mpv
阀	fam
绌	ius
储	iur
畜	iuw
魂	hye
阍	hym
婚	hyn
昏	hyp
拼	pbf
馄	hyu
珲	hyw
榀	pbm
诨	hyy
铽	tej
歉	qmq
千	qmp
乾	qmu
堑	qmt
囜	nbk
椠	qmm
肷	qmo
犍	qmn
忒	teq
素	suf
蔌	suc
踊	ysz
嗉	suk
塑	sut
速	suz
埂	ggt
颈	ggv
筘	kzv
绠	ggs
〇	lko
羹	ggy
侠	xxr
耿	gge
鲠	gga
叩	kze
梗	ggm
耕	ggl
鹒	ggn
眍	kzo
哽	ggk
榧	fwm
妃	fwn
扉	fwh
蜚	fwi
镄	fwj
废	fwg
鲱	fwa
痱	fwb
悱	fwx
砩	fwu
斐	fww
狒	fwq
绯	fws
捐	jrf
鄄	jre
涓	jrd
圈	jrk
绢	jrs
胥	xuv
肫	vyo
叹	tjk
夼	kld
邝	kle
怨	yrx
匚	kla
贶	klb
框	klm
德	der
呣	vmk
圹	klt
矿	klu
锝	dej
嘚	dek
狂	klq
纩	kls
绗	hhs
颃	hhw
航	hhv
抹	maf
恤	xux
巷	hhc
拷	kcf
吭	hhk
闰	rym
靴	xtg
聪	cse
淙	csd
匆	csg
丛	csa
唰	uxk
栲	kcm
悰	csx
囱	csp
遐	xxz
冰	bkd
邴	bke
犒	kcn
丙	bka
病	bkb
赇	qqb
鹙	qqn
炳	bkh
秋	qqh
囚	qqk
饼	bku
球	qqw
禀	bkw
铐	kcj
婿	xun
廊	lhg
恨	hfx
郎	lhe
朗	lhd
考	kct
狠	hfq
琶	paw
寇	kzb
锒	lhj
螂	lhi
稂	lhh
琅	lhw
债	vdr
哏	hfk
旭	xuj
狼	lhq
痕	hfb
齄	vap
酚	ffy
玢	ffw
鼢	ffu
坟	fft
纷	ffs
氛	ffq
瞓	ffo
黥	qkh
吩	ffk
焚	ffh
分	ffb
鲼	ffa
骺	hzg
僮	vlr
檠	qkm
瘊	hzb
糇	hzm
睺	hzo
狍	pcq
厚	hzi
锃	zgj
纠	jqs
堠	hzt
炮	pch
篌	hzv
猴	hzq
脬	pco
疱	pcb
抛	pcf
鲎	hzx
逅	hzz
殇	uhd
赏	uhb
扒	paf
晌	uho
栅	cem
觞	uhj
鲴	gua
厕	cei
策	cev
伤	uhr
侧	cer
册	cep
鳕	xta
帕	paj
恻	cex
尘	ift
碜	ifu
琛	ifw
衬	ifp
崮	gue
忱	ifx
趁	ifz
沉	ifd
抻	iff
宸	ifb
晨	ifo
称	ifh
雇	guh
艮	gfv
哏	gfk
根	gfm
茛	gfc
亘	gfa
瘳	izb
稠	izh
帱	izj
耪	phl
梼	izm
瞅	izo
臭	izp
绸	izs
畴	izt
故	guw
踌	izz
箍	guv
脯	puo
庞	phg
扑	puf
匍	pug
棉	mmm
娩	mmn
谱	puy
黾	mmk
孤	guz
埔	put
璞	puw
丏	mma
仆	pur
暂	zjo
糌	zjm
咱	zjk
錾	zjj
辗	zji
逄	phz
趱	zjz
氧	yhq
簪	zjv
斋	vdw
袭	xil
颇	pop
茈	zic
属	uuu
鲞	xlb
蛞	koi
眸	mzo
廓	kog
括	kof
磅	phu
扽	dff
阮	rre
脱	too
恼	ncx
钖	yhj
跄	qlz
刑	xkd
戕	qlv
猱	ncq
墙	qlt
垴	nct
硇	ncu
襁	qlp
瑙	ncw
嫱	qln
蛲	nci
铙	ncj
呶	nck
桡	ncm
嫐	ncn
抢	qlf
孬	nca
淖	ncd
挠	ncf
旸	yho
佢	kor
腌	aao
锕	aaj
蚌	bhi
镑	bhj
膀	bho
窃	qpb
茄	qpc
蒡	bhc
踄	uez
邦	bhe
浜	bhd
郄	qpe
谤	bhy
伽	qpr
绑	bhs
傍	bhr
挈	qpu
郦	lie
力	lig
恒	hgx
立	lil
脷	lio
衡	hgr
锂	lij
姮	hgn
桁	hgm
哼	hgk
蘅	hgc
钐	ujj
纂	zrv
戗	qlr
炅	jso
壤	rht
瓤	rhw
佧	kar
嚷	rhk
攘	rhf
矜	qbs
萜	tpc
琴	qbw
覃	qbx
约	ycs
寝	qbb
廑	qbg
螓	qbi
檎	qbm
呛	qlk
韫	yya
权	qrm
炝	qlh
蔡	cdc
材	cdm
赚	vrb
睬	cdo
嵊	uge
啋	cdk
省	ugx
猜	cdq
绳	ugs
逃	tcz
裁	cdy
踩	cdz
圣	ugt
苯	bfc
贲	bfb
掤	bff
奔	bfd
喯	bfk
锛	bfj
彻	ier
坼	iet
栟	bfm
屮	iev
畚	bfs
唓	iek
柙	xxm
笨	bfv
㬚	ieo
坌	bft
澈	ied
绦	tcs
汆	crr
爨	crp
篡	crv
饪	rfu
蹿	crz
认	rfy
忍	rfx
摇	ycf
荏	rfc
韧	rfa
刃	rfd
镩	crj
轫	rfi
稔	rfh
妊	rfn
载	zdi
瑟	sew
啬	seu
掏	tcf
塞	seb
槭	sem
铯	sej
乓	php
穑	seh
葬	zhc
倭	wor
肟	woo
幄	woj
挝	wof
垭	yat
莴	woc
窝	wob
讽	fgy
逢	fgz
述	uuz
封	fgt
砜	fgu
孰	uuw
鼠	uup
俸	fgr
缝	fgs
枫	fgm
姝	uun
烽	fgh
蜂	fgi
唪	fgk
啜	ikk
奉	fgf
膪	iko
丰	fga
疯	fgb
葑	fgc
迫	pdz
仂	ler
牌	pdp
掐	qxf
属	vuu
哌	pdk
拍	pdf
蒎	pdc
坠	vvt
锲	qpj
弱	rog
捎	ucf
藤	tgc
滕	tgo
黩	duh
镀	duj
嘟	duk
蠹	dua
赌	dub
芏	duc
毒	duf
牍	dup
独	duq
堵	dut
赃	zhb
笃	duv
尜	gax
酾	udy
伽	gar
胳	gao
轧	gai
尕	gag
敷	fuw
垺	fut
氟	fuq
椿	iym
鹑	iyn
讣	fuy
纯	iys
蚧	jpi
解	jpj
竭	jpl
睫	jpo
鲒	jpa
阶	jpe
斫	vou
驲	rim
禚	vop
囸	rik
倬	vor
缴	vos
结	jps
玠	jpw
孑	jpv
切	qpq
箧	qpv
滤	lvd
餸	ssi
荪	syc
损	syf
镫	dgj
噔	dgk
灯	dgh
抟	trf
榫	sym
僜	dgr
狲	syq
飧	syp
笋	syv
隼	syu
磴	dgu
蹬	dgz
孙	syz
瑾	jbw
供	gsr
躬	gsu
弓	gsv
迍	vyz
谆	vyy
近	jbz
谨	jby
养	yhy
争	vgd
恭	gsc
赆	jbb
拱	gsf
蚣	gsi
妗	jbn
觥	gsj
噤	jbk
龚	gsl
肱	gso
烬	jbh
赖	lda
函	hjv
犴	hjq
鼾	hjp
崃	lde
颔	hjr
铼	ldj
酣	hjy
顸	hja
籁	ldv
菡	hjc
阚	hjm
蚶	hji
卒	cuw
簇	cuv
猝	cuq
售	uzk
蹴	cuz
蹙	cug
殂	cud
蔟	cuc
扔	rgf
怔	vgx
闭	bim
铋	bij
萱	xrc
夸	kxd
愎	bix
襞	biy
纰	bis
狴	biq
烂	ljh
啉	ljk
愕	eex
遏	eez
噩	eew
雄	xsu
岚	lje
俄	eer
阏	eem
懒	ljx
腭	eeo
褴	ljp
扼	eef
鳄	eea
禅	ijp
缠	ijs
颤	ijw
忏	ijx
躔	ijz
觇	ija
蒇	ijc
巉	ije
廛	ijg
婵	ijn
囤	tyk
禳	rhp
铷	ruj
嚅	ruk
噌	cgk
娠	ufn
胩	kao
审	ufb
嶒	cge
孺	ruz
蹭	cgz
兄	xsk
儒	rur
缛	rus
绅	ufs
层	cgu
鲰	zza
珅	ufw
甭	bga
崩	bge
湓	pfd
穰	rhh
豺	idv
蚌	bgi
嘣	bgk
侪	idr
祊	bgp
柴	idm
钗	idj
泵	bgu
甏	bgw
迸	bgz
瘥	idb
虿	ida
重	vsp
哝	nsk
脓	nso
衰	ukw
恣	zix
侬	nsr
叶	xpk
解	xpj
溟	mkd
茗	mkc
勰	xpl
缶	fzr
鲑	xpa
唔	mkk
铭	mkj
螟	mki
缹	fzh
命	mkr
名	mkp
獬	xpq
血	xpp
亵	xpw
蝻	nji
酩	mky
㙦	xpt
珮	pww
培	pwt
佩	pwr
旆	pwf
陪	pwe
赔	pwb
鳃	sda
塞	sdb
眦	zio
胚	pwo
腮	sdo
刺	cid
呲	cik
劣	lpx
鹚	cin
伺	cir
兹	ciq
瓷	ciw
磁	ciu
词	ciy
慈	cix
臜	zao
脏	zho
南	nju
纶	lys
沦	lyd
垲	kdt
抡	lyf
袷	qxp
猎	lpq
癯	qub
轮	lyi
囵	lyk
管	grv
馆	gru
倌	grr
肭	nao
惯	grx
观	gry
纳	nas
莞	grc
鳏	gra
鹳	grn
乸	nax
咲	grk
爟	grh
轴	vzi
轨	gvi
捩	lpf
肘	vzo
妯	vzn
虽	svk
镦	dvj
队	dve
髓	svg
濉	svd
琢	vow
荽	svc
兑	dvb
昕	xbo
侉	kxr
谇	svy
碓	dvu
堆	dvt
碎	svu
绥	svs
裇	svp
俜	pkr
帚	vze
鸰	lkn
铃	lkj
鲮	lka
垮	kxt
黛	ddh
㥄	lkx
○	lkv
玲	lkw
绫	lks
脲	nno
桩	vlm
啾	jqk
厩	jqi
揪	jqf
酒	jqd
㠇	jqe
庄	vlg
尻	kcu
甙	ddc
赳	jqz
㑇	vzr
僦	jqr
歹	dda
熵	uhh
湍	trd
带	ddf
岱	dde
殆	ddd
疃	trt
彖	trv
朊	rro
麝	uel
钛	tdj
桡	rcm
涔	cfd
岑	cfe
軚	tdi
赊	ueb
敲	qnw
慑	uex
洒	sad
射	ueu
赦	uew
猞	ueq
谣	ycy
百	bda
掰	bdb
柏	bdm
夭	ycp
稗	bdh
呗	bdk
笙	ugv
拜	bdu
败	bdw
礵	uli
声	ugu
杳	ycm
药	ycc
耀	ycg
鲐	tda
崾	yce
踝	hkz
鳓	lea
怀	hkx
泐	led
勒	leg
徊	hkr
肋	leo
㷫	hkh
饹	leu
槐	hkm
玱	qlw
淮	hkd
劁	qnd
跆	tdz
酞	tdy
态	tdx
翘	qna
困	kyk
荞	qnc
犇	bfn
焜	kyh
孜	ziw
苍	chc
沧	chd
自	zip
鸧	chn
嵫	zie
锹	qnj
舱	chv
玱	chw
耔	zil
秭	zih
敕	iiw
锼	szj
喷	pfk
绡	xns
持	iif
茌	iic
啻	iil
螭	iii
炽	iih
孝	xnt
葩	pac
霄	xny
嗲	dxk
逍	xnz
祂	tap
獭	taq
讨	tcy
鳎	taa
它	tab
牠	tan
铊	taj
嗒	tak
缌	sis
藁	gcc
皋	gcb
郜	gce
饲	siu
搞	gcf
甩	ukp
萧	xnc
杲	gco
告	gcn
睾	gcp
缟	gcs
宵	xnb
司	sig
撕	sif
膏	gcw
篙	gcv
诰	gcy
锶	sij
赘	vvb
姒	sin
耜	sil
涅	npd
乜	npg
摄	npf
斯	siq
祀	sip
蹑	npz
臬	npp
锈	xqj
鞔	mjg
鳗	mja
髹	xqa
嫚	mjn
熳	mjh
螨	mji
庥	xqg
蛮	mjw
缦	mjs
绣	xqs
悗	mjx
谩	mjy
貅	xqv
琇	xqw
狡	jnq
思	six
筊	jnv
鬈	qra
跤	jnz
觉	jnx
珊	ujw
鲛	jna
铰	jnj
焦	jnh
㛚	tsn
瞳	tso
童	tsl
铜	tsj
嗵	tsk
捅	tsf
峒	tse
痛	tsb
舯	vsv
通	tsz
恸	tsx
酮	tsy
筒	tsv
垌	tst
砼	tsu
铨	qrj
彤	tsp
㟃	sie
瘩	dab
荙	dac
妲	dan
偻	lzr
㙘	yct
蝼	lzi
镂	lzj
褡	dap
耧	lzl
蒌	lzc
瘘	lzb
漏	lzd
搂	lzf
瑗	yrw
私	sih
奀	nfa
绻	qrs
畎	qrt
恁	nfx
犸	maq
遑	hlz
谎	hly
磺	hlu
徨	hlr
沤	oud
晃	hlo
讴	ouy
怄	oux
煌	hlh
偶	our
隍	hle
荒	hlc
鳇	hla
鬃	zsa
玛	maw
招	vcf
轺	yci
棹	vcm
喏	rek
罩	vcs
朝	vcu
笊	vcv
惹	rec
赵	vcz
狈	bwq
倍	bwr
孖	maz
璩	quw
备	bww
踎	bwz
曲	qua
北	bwa
蓓	bwc
揹	bwf
焙	bwh
辈	bwi
鹎	bwn
略	ltt
眢	yro
掠	ltf
锊	ltj
餮	tpu
麻	mag
猖	ihq
敞	ihw
场	iht
脶	loo
锠	ihj
堋	pgt
怍	vax
妈	man
皴	cys
榕	rsm
肜	rso
熔	rsh
蝾	rsi
溶	rsd
嵘	rse
忖	cyx
融	rsa
冗	rsb
寸	cya
吋	cyk
狨	rsq
村	cym
绒	rss
霪	yby
缘	yrs
饮	ybu
尹	ybv
珢	ybw
音	ybl
姻	ybn
荛	rcc
引	ybg
纽	nqs
狃	nqq
溴	xqd
忸	nqx
岫	xqe
钮	nqj
妞	nqn
楦	xrm
秘	mih
嬛	xrn
轩	xri
麋	mil
羞	xqy
芈	mia
蘼	mic
搣	mif
迷	miz
谖	xry
悬	xrx
猕	miq
祢	mip
屘	miu
敉	miw
汪	whd
魍	whg
枉	whm
婶	sfn
往	whr
涮	urd
谮	zfy
梵	fjm
贩	fjb
繁	fjs
犯	fjq
璠	fjw
畈	fjt
娑	son
螋	szi
瞍	szo
橐	toa
薮	szc
溲	szd
叟	szp
艘	szv
染	rjm
茏	lsc
箜	ksv
倥	ksr
啱	ngo
恐	ksx
孔	ksz
崆	kse
控	ksf
缮	ujs
澡	zcd
坜	lit
㠓	mge
濛	mgd
黾	mgk
氓	mgw
礞	mgu
氯	lvq
睦	muo
褛	lvp
碟	dpu
绖	dps
佚	dpr
牒	dpp
颡	shy
瓞	dpg
爹	dpf
鲽	dpa
嗓	shk
蝶	dpi
确	qtu
怗	tpx
缺	qtf
瘸	qtb
鹊	qtn
炔	qth
恕	uux
禄	lup
僇	lur
绿	lus
垆	lut
逯	luz
赂	lub
陆	lue
踹	ikz
镥	luj
噜	luk
麓	lul
胪	luo
瞌	keo
稞	keh
髁	keg
咒	vzj
苛	kec
颗	kea
专	vra
课	key
恪	kex
坷	ket
缂	kes
锦	jbj
氪	keq
竖	uul
肌	jio
输	uui
膪	vdo
搋	ikf
绍	ucs
殳	uuj
藻	zcc
睿	rva
茼	tsc
冥	mkb
哨	uck
膑	bbo
讶	yay
镔	bbj
迓	yaz
髌	bbg
摈	bbf
氩	yaq
宾	bbb
鬓	bba
桠	yam
睚	yao
炻	uih
赎	uub
缤	bbs
傧	bbr
芽	yac
崚	lge
愣	lgx
匙	uio
塄	lgt
麒	qil
镛	ysj
蛹	ysi
㶲	ysh
臃	yso
悴	cvx
翠	cvy
璀	cvw
鳙	ysa
庸	ysg
拥	ysf
统	tss
脆	cvo
啐	cvk
焠	cvh
摧	cvf
淬	cvd
崔	cve
瘁	cvb
萃	cvc
露	lzy
闯	ilm
垺	pzt
裒	pzw
棓	pzm
哣	pzk
憎	zgx
弹	tjg
蚕	cja
残	cjd
阼	zoe
璨	cjw
餐	cju
嘴	zvk
螃	phi
踔	ioz
侔	mzr
镯	voj
绰	ios
谋	mzy
滂	phd
婥	ion
啜	iok
淖	iod
蛑	mzi
鍪	mzj
撙	zyf
鳟	zya
樽	zym
喽	lzk
脞	coo
娄	lzm
遵	zyz
篆	vrv
鞔	mfg
焖	mfh
钔	mfj
饕	tcu
闷	mfm
谭	tjy
焘	tch
懑	mfx
弢	tcg
篓	lzv
萄	tcc
韬	tca
髅	lzg
铥	dqj
钕	nvj
镶	xlj
牤	mhn
铓	mhj
漭	mhd
邙	mhe
戚	qig
芎	xsc
匈	xsg
忙	mhx
熊	xsh
硭	mhu
胸	xso
礓	jlu
楷	kdm
终	vss
僵	jlr
剀	kdd
凯	kde
揩	kdf
妠	njn
楠	njm
蒈	kdc
降	jle
耩	jll
犟	jln
烱	jlh
匠	jlk
肿	vso
佃	tmr
填	tmt
恬	tmx
忝	tma
掭	tmf
畑	tmh
田	tmk
腆	tmo
岛	dcn
囔	nhk
帱	dcj
叨	dck
刀	dcg
导	dcv
倒	dcr
祷	dcp
氘	dcq
柰	ndm
奶	ndn
耐	nda
奈	ndd
款	kru
罨	yjs
迺	ndz
氖	ndq
佴	ndr
髋	krg
馕	nhu
鸥	oun
铡	vaj
炸	vah
痄	vab
饶	rcu
冧	lfb
揸	vaf
渣	vad
碳	tju
藕	ouc
娆	rcn
诈	vay
乍	var
扰	rcf
猹	vaq
瘰	lob
逋	buz
怖	bux
醭	buy
补	bup
布	buu
晡	buo
瓿	bul
卜	bua
捕	buf
钿	dmj
奠	dmq
佃	dmr
簟	dmv
玷	dmw
惦	dmx
踮	dmz
吕	lvk
铝	lvj
罴	pih
铍	pij
枇	pim
媲	pin
丕	pia
芘	pic
庀	pig
裨	pip
狉	piq
栊	lsm
觜	zvj
硖	xxu
蕞	zvc
醉	zvy
罪	zvs
霞	xxy
㤘	vzx
腙	zso
鸨	bcn
龅	bci
抱	bcf
包	bcg
鲍	bca
宝	bcb
雹	bcy
堡	bct
饱	bcu
豹	bcv
褒	bcw
保	bcr
婴	ykn
爪	vcp
枚	mww
暇	xxo
雪	xty
魅	mwg
嵋	mwe
湄	mwd
镁	mwj
昧	mwo
梅	mwm
婉	wjn
宛	wjb
春	iyf
纨	wjs
防	fhe
仔	zdr
方	fhw
仿	fhr
唇	iyi
汹	xsd
佢	qur
缲	scs
库	kug
喎	wdk
断	drm
刁	dng
茁	voc
叼	dnk
碉	dnu
嚟	lwk
泪	lwd
凝	nkd
酬	izy
见	jmk
煎	jmh
腱	jmo
鞯	jmg
跳	tnz
尔	erd
鲦	tna
耳	era
裟	uay
砂	uau
沙	uad
货	hob
获	hoc
嚯	hok
伙	hor
腊	lao
啦	lak
除	iue
朕	vfo
振	vff
浈	vfd
砢	lou
诊	vfy
硫	lqu
圳	vft
六	lqw
务	wuw
武	wuv
坞	wut
芜	wuc
寤	wub
五	wua
捂	wuf
邬	wue
污	wud
钨	wuj
攀	pjm
盼	pjo
轻	qki
妮	nin
蝈	goi
懂	dsx
锅	goj
胴	dso
猓	goq
董	dsc
缀	vvs
墟	xut
憧	isx
徐	xur
蓄	xuc
庆	qkg
青	qkf
皿	mbk
倪	nir
氢	qkq
擎	qku
跎	toz
西	xia
习	xig
妥	tov
唾	tok
奚	xiv
拖	tof
吝	lbw
躏	lbz
临	lba
邻	lbe
淋	lbd
衅	xbx
瞵	lbo
靳	jbg
嘉	jxu
镕	rsj
挣	vgf
迦	jxz
津	jbd
郏	jxe
挟	jxf
晋	jba
朵	doj
趔	lpz
驮	dom
扬	yhf
隋	doe
踱	doz
歇	xpo
冽	lpd
苹	pkc
冯	pkd
频	pbv
缓	hrs
嬛	hrn
唤	hrk
锾	hrj
鲩	hra
巴	bav
霸	bay
靶	bag
鲅	baa
粑	bam
吧	bak
川	irp
模	mum
牡	mun
循	xyr
慵	ysx
扣	kzf
刮	gxd
辛	xbl
瓜	gxp
朴	pom
铮	vgj
朴	pnm
冇	mci
卯	mce
袤	mcw
矛	mcs
稳	wfh
埃	ait
哀	aiw
梭	som
揾	wff
隘	aie
纹	wfs
攵	wfp
挨	aif
艾	aic
癌	aib
遛	lqz
荡	dhc
鹠	lqn
惊	jkx
拟	nif
径	jkr
竟	jkl
精	jkm
井	jka
茎	jkc
趟	thz
羰	thy
棠	thx
堂	tht
倘	thr
糖	thm
螳	thi
旋	xrf
腋	yeo
芝	vic
狱	yuq
液	yed
朴	pum
圃	puk
绵	mms
诂	guy
攒	zjf
赞	zjb
瓒	zjw
锡	xij
阔	kom
抓	vxf
墅	uut
羟	qly
脑	nco
庐	lug
吖	aak
彭	bhu
亨	hgw
礼	lip
荥	xkc
止	via
镖	bnj
鳔	bna
君	jyv
酪	lcy
牢	lcb
芟	ujc
姥	lcn
铑	lcj
俊	jyr
郡	jye
军	jyb
菌	jyc
摘	vdf
竣	jyl
尾	wwu
猥	wwq
维	wws
谓	wwy
慰	wwx
违	wwz
桅	wwm
拦	ljf
帷	wwj
吵	ick
炒	ich
罂	ykf
潮	icd
弘	hsg
哄	hsk
虹	hsi
闽	mbm
昂	aho
悯	mbx
累	lwt
哇	wak
瓦	waa
宙	vzb
噪	zck
叔	uua
油	yzd
栓	urm
蛴	qii
讫	qiy
糠	khm
砌	qiu
祈	qip
惕	tix
绨	tis
梯	tim
替	tio
缄	jms
型	xkt
溃	kvd
葵	kvc
睽	kvo
鹰	ykg
逵	kvz
喨	llk
量	llo
凉	lld
者	vet
毅	yil
折	vef
颖	ykp
棣	dim
嫡	din
滴	did
抵	dif
底	dig
蒂	dic
递	diz
第	div
氐	dip
低	dir
偏	pmr
呻	ufk
骗	pmm
犏	pmn
翩	pmh
顷	qka
跛	boz
蜩	tni
伯	bor
亳	bow
噃	bok
脖	boo
卜	boa
搏	bof
授	uzf
绉	vzs
身	ufp
伸	ufr
噢	ook
颜	yjl
筵	yjv
爽	uld
构	gzm
苟	gzc
篝	gzv
讼	ssy
遁	dyz
昼	vzu
隩	aoe
敖	aow
袄	aop
嘛	mak
骂	mam
舡	ghv
纲	ghs
扛	ghf
杠	ghm
隆	lse
窿	lsb
聋	lsl
垄	lst
蛋	djv
顿	dya
玑	jiw
啖	djk
宋	ssb
炭	tje
蒯	kkd
丧	shu
厢	xli
项	xlg
象	xld
详	xly
享	xlw
向	xlp
钥	ytj
熏	xyh
曰	ytk
豪	hcw
蒿	hcc
昊	hco
恋	lmx
严	yja
裢	lmp
敛	lmw
链	lmj
梿	lmm
脸	lmo
聿	yuv
薢	xpc
斩	vji
酋	qqq
搌	vjf
勇	yss
鞋	xpg
卸	xpe
喳	iak
锸	iaj
刹	iad
插	iaf
察	iab
圯	yit
叉	iay
䥺	yaj
碴	iau
兖	yjw
互	hua
葫	huc
蝴	hui
琥	huw
乎	hup
狐	huq
纵	zss
按	anf
鞍	ang
桉	anm
暗	ano
唵	ank
垵	ant
氨	anq
昨	zoo
作	zor
咏	ysk
越	ytz
阳	yhe
莛	tkc
厅	tki
粤	ytp
弋	yiq
闲	xmm
显	xmo
燹	xmh
孅	xmi
冼	xmd
掀	xmf
咸	xmg
献	xmu
舷	xmv
衔	xmr
线	xms
硌	geu
圪	get
砘	dyu
革	gec
戈	gea
吨	dyk
铬	gej
蛤	gei
胳	geo
格	gem
撩	lnf
诀	jty
玦	jtw
爵	jtv
橛	jtm
觖	jtj
刖	ytd
赠	zgb
土	tuu
荼	tuc
兔	tud
碇	dku
忠	vsx
铸	vuj
订	dky
侃	kjr
堪	kjt
叮	dkk
蛔	hvi
秽	hvh
桧	hvm
晦	hvo
嬲	nnn
彗	hve
辉	hvg
钋	poj
绘	hvs
灰	hvu
瞓	xyo
唥	lhk
贬	bmb
煸	bmh
砭	bmu
嗨	hdk
憩	qix
嘱	vuk
槛	kjm
爬	pav
划	hxd
骅	hxm
勘	kjq
绮	qis
杷	pam
砍	kju
㕮	tnk
星	xko
善	ujy
逐	vuz
禅	ujp
槽	ccm
姗	ujn
郑	vge
曹	cca
犹	yzq
钙	gdj
邢	xke
概	gdm
默	moh
脉	moo
嬷	mon
寞	mob
摸	mof
敢	gjw
肝	gjo
硎	xku
甘	gjc
颓	tvh
呪	vzk
逮	ddz
袋	ddy
骤	vzm
待	ddr
诌	vzy
癸	gvv
攰	gvu
侨	qnr
苔	tdc
诮	qny
峤	qne
台	tds
樵	qnm
辗	nmi
痘	dzb
陡	dze
唞	dzk
辰	ifi
碣	yau
蜷	qri
般	bjv
匀	yyg
悛	qrx
壑	het
萝	loc
禾	hep
合	her
锣	loj
啰	lok
河	hed
荷	hec
逻	loz
疽	jub
剧	jud
聚	jue
巨	juk
焗	juh
瞿	juo
俱	jur
崖	yae
冉	rja
证	vgy
举	jux
讵	juy
押	yaf
牙	yaa
仗	vhr
杖	vhm
章	vhl
帐	vhj
涨	vhd
丫	yab
账	vhb
实	uib
示	uie
濑	ldd
驶	uim
式	uiq
室	uit
恃	uix
适	uiz
承	igv
城	igt
乘	igp
诚	igy
撑	igf
遂	svz
铖	igj
愠	yyx
疣	yzb
峋	xye
缈	mns
妙	mnn
瞄	mno
苗	mnc
渺	mnd
铀	yzj
呦	yzk
厨	iui
触	iuj
发	fav
怵	iux
蹰	iuz
初	iup
础	iuu
冻	dsd
峒	dse
邮	yze
谴	qmy
迁	qmz
纤	qms
签	qmv
虔	qmh
溯	sud
宿	sub
甦	sua
夙	suj
肃	suv
俗	sur
粟	sux
忑	tex
蔻	kzc
庚	ggg
喆	veu
沸	fwd
雍	ysw
狭	xxq
菲	fwc
飞	fwv
娟	jrn
秩	vih
镌	jrj
倦	jrr
狷	jrq
志	vix
识	viy
奏	zzf
畜	xuw
旷	klo
诓	kly
夯	hhd
杭	hhm
枞	csm
蚂	mai
葱	csc
琮	csw
抦	bkf
裘	qqa
兵	bkp
丘	qqp
仇	qqr
逑	qqz
莨	lhc
缯	zgs
愤	ffx
份	ffr
暄	xro
芬	ffc
薛	xtc
吼	hzk
候	hzr
菇	guc
垧	uht
晕	yyo
尚	uhx
汩	gud
谶	ify
郴	ifm
臣	ifk
蛊	gum
椎	vvm
仇	izr
丑	izv
愁	izx
扇	ujh
跞	liz
囧	jsk
爻	ycx
陕	uje
迥	jsz
衒	xrr
铁	tpj
沁	qbd
钦	qbj
财	cdb
采	cdv
升	ugp
掣	ieu
撤	ief
铉	xrj
仁	rfr
壬	rfp
撺	crf
蕹	wgc
涩	sed
鄱	poe
斡	wou
龌	woi
魄	pob
书	uuv
锋	fgj
峰	fge
抒	uuf
派	pdd
央	yha
准	vyd
疼	tgb
杜	dum
妒	dun
渡	dud
喧	xrk
叁	sjs
夹	gaa
砆	fuu
朐	iyo
覆	fux
附	fue
妇	fun
驸	fum
幅	fuj
馥	fuh
杰	jph
嗟	jpk
戒	jpg
界	jpt
诸	vuy
登	dgd
邓	dge
瞪	dgo
恙	yhx
凳	dgv
尽	jbu
攻	gsw
工	gsa
禁	jbm
韩	hju
赉	ldb
邯	hje
寒	hjb
焊	hjh
喊	hjk
促	cur
醋	cuy
狸	liq
臂	bio
秘	bih
庇	big
鄙	bie
敝	biw
畀	bit
彼	bir
览	ljj
讹	eey
饿	eeu
堨	eet
征	vgr
锷	eej
鄂	eee
缆	ljs
额	eeb
谗	ijy
单	ijb
掺	ijf
蝉	iji
铲	ijj
阐	ijm
首	uzq
嚏	tik
辱	rui
糁	ufm
肾	ufo
莘	ufc
吞	tya
楱	zzm
砷	ufu
㶶	nsh
农	nsd
蟹	xpi
瞑	mko
衷	vsw
囡	njk
绁	xps
斜	xpr
啱	njo
髭	zia
沛	pwd
锫	pwj
呸	pwk
茨	cic
赐	cib
咨	zik
辞	cip
此	civ
伦	lyr
矜	grs
钠	naj
娜	nan
罐	grf
灌	grd
棺	grm
匮	gvk
睢	svo
穗	svh
皈	gvb
怼	dvx
戴	ddt
呆	ddk
呤	lkk
蛉	lki
凌	lkd
苓	lkc
零	lky
鸠	jqn
究	jqb
烤	kch
芫	yjc
剩	ugd
援	yrf
蛇	uei
胎	tdo
社	uep
旗	qif
遥	ycz
摆	bdf
枱	tdm
徭	ycr
淞	ssd
瑶	ycw
钥	ycj
腰	yco
伯	bdr
尧	yca
叻	lek
燥	zch
娶	qun
酌	voy
昆	kyo
子	ziv
紫	zis
兹	ziq
孖	ziz
谘	ziy
仓	chr
资	zib
姿	zin
讬	toy
锱	zij
髡	kya
辎	zii
侈	iir
迟	iiz
耻	iie
池	iid
弛	iig
痴	iib
驰	iim
鸱	iin
筱	xnv
蛀	vui
塔	tat
抬	tdf
拓	taf
榻	tam
稿	gch
锆	gcj
堃	kyt
驷	sim
啮	npk
镊	npj
孽	npc
揄	yuf
满	mjd
蔓	mjc
瞒	mjo
幔	mjj
墁	mjt
馒	mju
臭	xqp
绞	jns
酵	jny
皎	jnb
荃	qrc
搅	jnf
郊	jne
嚼	jnk
脚	jno
桶	tsm
劏	tsd
妍	yjn
绿	lvs
纫	rfs
打	daf
鞑	dag
答	dav
惮	dax
达	daz
殒	yyd
咬	yck
璜	hlw
簧	hlv
蝗	hli
皇	hlb
照	vch
嘲	vck
昭	vco
蜅	puz
卑	bwp
趋	quz
取	que
陂	bwe
庳	bwg
钡	bwj
呗	bwk
杯	bwm
背	bwo
埏	yjt
宰	zdb
抨	pgf
苑	yrc
唱	ihk
娼	ihn
昌	iho
氅	ihm
苌	ihc
龈	ybi
淌	ihd
㑩	lor
络	los
存	cyu
嗅	xqk
狺	ybq
银	ybj
淫	ybd
邂	xpz
扭	nqf
咪	mik
泌	mid
觅	miv
牧	muw
网	whk
忘	whx
烦	fjh
返	fjz
番	fjp
饭	fju
飕	szf
昱	yuo
掹	mgf
幪	mgj
朦	mgo
猛	mgq
艋	mgv
懵	mgx
迭	dpz
叠	dpy
喋	dpk
雀	qtx
碌	luu
露	luy
芦	luc
撸	luf
炉	luh
鸬	lun
咳	kek
蝌	kei
㞹	kee
枣	zca
珂	kew
彘	viv
狁	yyq
艄	ucv
勺	ucg
冯	fgd
邵	uce
芍	ucc
杓	ucm
辑	jii
庶	uug
烧	uch
彬	bbm
邠	bbe
殡	bbd
衙	yar
轼	uii
斌	bbw
及	jip
棱	lgm
矬	cou
佣	ysr
墉	yst
俳	pdr
抔	pzf
粲	cjm
探	tjf
惨	cjx
膀	pho
缪	mzs
醴	liy
龊	ioi
彷	phr
哞	mzk
门	mfd
扪	mff
桃	tcm
忐	tjx
陶	tce
砖	vru
陋	lze
猪	vuq
毯	tjm
恧	nvx
蟒	mhi
盲	mhw
仲	vsr
缰	jls
疆	jlg
茳	jlc
男	njt
桨	jlm
钟	vsj
甜	tmp
兲	tmw
枪	qlm
钿	tmj
栝	tmm
盗	dcm
稻	dch
道	dcz
悼	dcx
艿	ndc
乃	ndg
灼	voh
轧	vai
眨	vao
鸳	yrn
院	yre
猿	yrq
爰	yrv
栩	xum
步	buv
埔	but
钚	buj
卟	buk
履	lvu
电	dma
癫	dmb
淀	dmd
巅	dme
店	dmg
韵	yyl
旅	lvf
垫	dmt
虑	lvh
蚍	pii
脾	pio
披	pif
譬	piy
僻	pir
罢	pis
琵	piw
摞	lof
艽	qqc
剥	bcd
孢	bcz
褓	bcp